1111111111111111111111111111111111
1E0000000000000C000000000C00000001
10C0010100100000101001000000010101
1010010010C010100010010000000C0101
1P00000000000000000000000000000001
1111111111111111111111111111111111