1111111111111111111111111111111111
1CCC00000000000C000000000C00000001
1CCC0101E0100000101001000000010101
1010010010C010100010010000000C0101
1P00000000000000000000000000000001
1111111111111111111111111111111111