11111111111
1CCCCCCCCC1
1CCCCCCECC1
1CCPCCCCCC1
1CCCCCCCCC1
11111111111