11111111111111111111
1100C10000000C000EP1
1C0001000C00000001C1
1110110000C000101001
10000000C01111000001
11111111111111111111