11111111111111111111
110PC10000000C000001
1C0001000C000E0001C1
1110110000C000101001
10000000C01111000001
11111111111111111111