11111111111
10100000101
11P10001E11
10100100001
10001C10001
10000000001
11111111111