111111111111111111111111111111
100C10C00000000000000000000001
1000100010000000C000000000E001
100010010000000000000000000001
1000101C0000000000000000000001
10001111110000000C000000000001
10000000000000000000000P00000
100000000000000000000000000001
100000000001000000000000000001
100011111111110000000000000001
100000000000C1000000000000C001
111111111111111111111111111111